ClassID,Stage,MonsterLevel,NormalCount,EliteCount,BossCount,PatternArg1,Pattern
1,1,50,20,0,0,0,
2,2,60,10,2,0,0,
3,3,70,13,3,0,0,
4,4,80,15,5,0,0,
5,5,90,10,1,1,0,
6,6,100,20,0,0,0,
7,7,120,10,2,0,0,
8,8,140,13,3,0,0,
9,9,160,15,5,0,0,
10,10,180,10,1,1,0,
11,11,200,20,0,0,0,
12,12,220,10,2,0,0,
13,13,240,13,3,0,0,
14,14,260,15,5,0,0,
15,15,280,10,1,1,0,
16,16,300,20,0,0,0,
17,17,310,10,2,0,0,
18,18,320,13,3,0,0,
19,19,330,15,5,0,0,
20,20,340,10,1,1,0,
21,21,350,20,0,0,0,
22,22,360,10,2,0,0,
23,23,370,13,3,0,0,
24,24,380,15,5,0,0,
25,25,390,10,1,1,0,
26,26,400,20,0,0,0,
27,27,410,10,2,0,0,
28,28,420,13,3,0,0,
29,29,430,15,5,0,0,
30,30,440,10,1,1,0,
31,31,450,20,0,0,0,
32,32,450,10,2,0,0,
33,33,450,13,3,0,0,
34,34,450,15,5,0,0,
35,35,450,10,1,1,0,
36,36,450,20,0,0,0,
37,37,450,10,2,0,0,
38,38,450,13,3,0,0,
39,39,450,15,5,0,0,
40,40,450,10,1,1,0,
41,41,460,20,0,0,0,
42,42,460,10,2,0,0,
43,43,460,13,3,0,0,
44,44,460,15,5,0,0,
45,45,460,10,1,1,0,
46,46,470,20,0,0,0,
47,47,470,10,2,0,0,
48,48,470,13,3,0,0,
49,49,470,15,5,0,0,
50,50,470,10,1,1,0,
